+--+--+--+--+--+--+--+--+--+--+--+--+--+--+--+--+--+--+--+--+--+--+--+--+  +--+--+--+--+--+--+--+--+--+--+--+--+--+--+--+--+--+--+--+--+--+--+--+--+
|  |           |        |                             |              |                                |  |                    |                 |  |
+  +  +--+--+  +  +--+  +  +--+--+--+--+--+--+--+  +--+  +--+  +--+  +--+--+--+  +--+--+--+  +--+--+  +  +  +--+  +--+--+--+--+  +--+--+--+  +  +  +
|           |     |     |     |                 |     |  |  |     |              |     |     |     |     |     |           |        |        |     |
+--+--+--+--+--+--+  +  +--+  +  +--+--+--+--+  +--+  +  +  +--+  +--+--+--+--+  +  +  +--+--+  +  +--+--+--+  +--+--+--+  +  +--+--+  +--+  +--+--+
|                 |  |  |     |     |                 |  |     |           |     |  |        |  |     |        |     |     |  |        |     |     |
+  +--+--+--+--+  +  +--+  +--+--+  +  +--+--+--+--+  +  +  +--+--+--+--+  +  +--+  +--+--+  +  +--+  +  +--+--+  +--+  +--+  +  +--+--+--+--+  +  +
|           |  |  |        |        |  |     |        |  |              |  |     |        |     |     |        |     |        |           |     |  |
+  +--+--+  +  +  +--+--+--+  +--+--+  +  +  +--+--+--+  +  +--+--+  +--+  +--+--+--+--+  +--+--+  +--+--+--+  +--+  +--+--+--+--+--+--+  +  +--+  +
|        |  |                 |     |  |  |        |     |  |  |     |     |                    |           |           |  |           |  |     |  |
+  +--+--+  +--+--+--+--+  +--+  +  +  +  +--+--+  +  +--+  +  +  +--+  +--+  +--+--+--+--+--+--+  +--+--+  +--+--+--+  +  +  +--+  +  +  +--+  +  +
|  |        |     |        |     |  |  |        |  |  |        |     |           |              |        |     |        |  |     |  |  |        |  |
+  +  +--+--+  +  +--+--+  +  +--+  +--+--+--+  +  +  +--+--+--+--+  +--+--+--+--+  +  +--+--+  +--+--+--+  +--+  +--+--+  +--+  +  +--+--+--+--+  +
|  |           |        |  |  |  |        |  |  |                       |           |  |     |              |     |     |     |  |           |     |
+  +--+--+--+--+  +--+  +  +  +  +--+  +  +  +  +--+--+--+--+--+--+--+--+  +--+--+--+--+  +  +--+--+--+  +--+  +--+  +  +  +  +  +--+--+  +  +  +--+
|  |           |     |  |  |     |     |     |  |                          |              |  |     |     |     |  |  |  |  |     |     |  |  |     |
+  +  +--+--+  +--+--+  +--+  +--+  +--+--+--+  +  +--+--+--+--+--+--+--+--+  +--+--+--+--+  +  +  +--+--+  +--+  +  +  +  +--+--+  +--+  +--+--+  +
|  |        |        |  |     |     |        |  |     |                             |        |  |           |        |  |  |           |     |     |
+--+--+--+  +--+--+  +  +  +--+  +--+  +--+  +  +--+  +  +--+--+--+--+--+--+--+--+--+  +--+--+  +--+--+--+--+  +--+--+  +  +--+--+--+  +--+  +  +--+
|           |     |     |  |  |           |     |     |     |     |                 |        |     |        |  |        |     |        |     |     |
+  +  +--+--+  +  +--+--+  +  +--+--+--+--+--+--+  +--+--+  +  +--+  +--+--+--+--+  +--+--+  +--+  +  +--+  +--+  +--+--+--+  +  +--+--+  +--+--+  +
|  |  |        |              |              |     |           |     |     |     |              |  |     |        |           |        |  |     |  |
+  +--+  +--+--+--+--+--+--+  +  +--+--+--+  +  +--+  +--+--+--+  +--+  +  +  +  +--+--+--+--+  +  +  +  +--+--+--+  +--+--+--+--+--+  +  +  +  +  +
|        |  |     |     |     |        |        |     |  |        |     |  |  |        |     |  |  |  |                       |        |     |  |  |
+  +--+--+  +  +  +  +  +--+  +--+--+  +--+  +--+  +--+  +  +--+--+  +--+  +--+  +  +--+  +  +  +  +--+--+--+--+--+--+--+--+  +  +--+--+--+--+  +  +
|     |     |  |     |     |        |     |  |     |     |           |  |     |  |        |     |                    |        |     |           |  |
+--+  +  +--+  +--+--+--+  +--+--+  +--+  +--+  +--+--+  +--+--+--+--+  +--+  +--+--+--+--+--+--+--+--+--+--+--+--+  +  +--+--+  +  +  +  +--+--+  +
|  |  |     |  |     |  |  |        |     |     |     |           |        |  |                                   |  |  |     |  |  |  |  |        |
+  +  +--+  +  +  +  +  +  +--+--+--+  +  +  +--+  +  +--+  +--+  +  +  +--+  +  +--+--+--+--+  +--+--+--+--+--+--+  +  +  +  +--+  +  +--+  +--+--+
|           |     |  |           |     |  |  |     |     |     |  |  |     |  |  |     |        |     |           |  |     |        |  |     |     |
+  +--+--+--+  +--+  +--+--+--+  +  +--+--+  +--+  +--+  +--+--+  +  +--+  +  +  +--+  +  +--+--+  +  +  +--+--+  +  +--+--+--+--+--+  +  +--+  +  +
|  |        |     |        |     |  |     |     |     |        |     |     |           |     |     |           |     |                 |        |  |
+  +  +--+  +--+--+--+  +  +--+  +  +  +  +--+  +--+  +--+--+  +  +--+  +--+--+--+--+--+--+  +  +--+--+--+--+--+  +--+  +--+--+--+--+  +--+--+--+  +
|  |  |  |           |  |     |     |  |     |     |        |  |     |  |                 |     |              |        |  |        |           |  |
+--+  +  +--+--+--+  +--+--+  +  +--+  +  +--+--+  +--+--+  +  +--+--+  +  +--+--+--+--+  +--+--+  +--+--+--+  +--+--+--+  +  +  +--+  +--+--+--+  +
|     |                       |  |     |                    |           |  |        |              |     |              |     |        |           |
+  +--+--+  +--+--+--+--+--+--+--+  +--+--+--+--+--+--+--+--+--+--+--+--+  +  +--+  +--+--+  +--+--+  +  +--+--+--+--+  +--+--+--+  +--+  +--+--+  +
|        |  |  |        |              |                                   |     |        |  |     |  |        |     |           |     |        |  |
+  +--+  +  +  +  +--+  +  +--+--+--+--+  +--+--+--+--+  +--+--+--+  +--+--+  +--+--+--+  +--+  +  +  +--+--+  +  +  +--+--+--+  +--+--+--+--+  +  +
|     |  |     |  |     |     |     |     |     |  |     |     |     |        |           |     |     |     |  |  |  |                          |  |
+--+  +  +--+  +  +  +--+--+  +--+  +  +  +  +  +  +  +--+  +  +--+--+  +--+--+  +--+--+--+  +--+--+--+  +  +  +  +  +--+--+--+--+--+--+--+--+--+--+
|     |     |  |  |        |     |  |  |  |  |  |     |     |  |     |  |        |           |     |     |  |  |  |  |           |     |           |
+  +--+--+  +--+  +--+--+  +--+  +  +  +--+  +  +  +--+  +--+  +  +  +  +  +--+--+  +--+--+--+  +  +--+--+  +  +  +  +  +--+--+  +  +  +  +--+--+  +
|     |     |     |     |     |     |  |     |  |     |  |  |  |  |     |  |        |  |        |           |     |        |  |  |  |     |        |
+--+  +  +--+  +--+  +--+  +--+  +--+  +  +--+  +--+--+  +  +  +  +--+--+  +  +--+--+  +  +  +--+--+--+  +--+--+--+--+--+  +  +  +  +--+--+  +--+--+
|  |  |              |     |     |     |     |        |     |     |        |     |  |     |  |        |  |           |        |  |  |     |        |
+  +  +--+--+--+--+--+  +--+  +--+  +  +--+  +--+--+  +--+  +--+--+  +--+--+--+  +  +  +--+  +  +--+  +--+  +--+--+  +--+--+--+  +  +--+  +--+--+  +
|     |        |        |     |     |  |  |  |     |        |     |        |     |  |  |  |  |  |     |     |  |                 |     |        |  |
+  +--+--+  +--+  +--+--+  +--+  +--+  +  +  +  +--+--+--+--+  +  +--+--+  +  +--+  +  +  +  +  +  +  +  +--+  +  +--+--+--+--+--+--+  +--+  +--+  +
|           |     |     |  |  |     |  |  |  |  |              |        |  |  |           |     |  |  |     |     |                       |     |  |
+--+--+--+  +  +--+  +  +  +  +--+  +  +  +  +  +  +  +--+--+--+--+--+  +  +  +--+--+--+--+  +--+  +--+--+  +  +--+  +--+--+--+--+--+--+  +--+  +  +
|  |        |        |        |     |     |  |  |  |  |        |     |     |              |  |     |        |  |     |              |  |  |     |  |
+  +  +--+--+--+--+--+--+--+--+  +--+--+--+  +  +  +--+  +--+  +  +  +--+--+  +--+--+--+  +--+  +--+  +--+--+--+  +--+  +--+--+--+  +  +  +  +--+  +
|     |                          |           |  |  |        |     |  |     |  |        |     |  |     |           |     |        |  |        |     |
+  +--+  +--+--+--+--+  +--+--+--+  +--+--+--+  +  +  +--+--+--+--+  +  +  +  +  +--+  +--+  +  +  +--+  +--+--+--+  +  +--+--+  +  +--+--+--+  +  +
|     |        |        |           |           |  |  |  |           |  |  |  |  |     |        |     |  |        |  |  |     |                 |  |
+--+--+--+  +  +--+--+  +  +--+--+--+  +--+  +  +  +  +  +  +--+--+--+  +  +  +  +--+  +--+--+--+--+  +  +  +--+--+  +  +  +  +--+--+--+--+--+--+  +
|        |  |        |  |     |        |     |  |        |              |     |     |                 |  |  |        |  |  |        |           |  |
+  +--+  +--+--+--+  +--+--+  +--+--+--+  +--+--+--+--+--+--+--+--+--+--+--+--+--+  +--+--+--+--+--+  +  +  +  +--+--+--+  +--+--+  +  +--+--+  +  +
|     |              |     |           |  |                                         |     |        |  |     |                    |  |  |     |  |  |
+  +  +--+--+--+  +--+  +  +--+--+--+  +  +  +--+--+--+--+--+--+--+--+--+--+--+  +--+  +  +  +--+  +--+--+  +--+--+--+--+--+--+  +  +  +  +--+  +  +
|  |  |           |     |        |        |              |                 |     |     |  |     |  |        |              |     |  |  |     |  |  |
+--+  +--+--+--+--+  +--+--+--+  +  +--+--+--+--+--+--+  +  +--+  +--+--+--+  +--+  +--+  +  +--+  +  +--+--+  +--+--+--+  +--+--+  +  +--+  +  +--+
|     |     |                 |     |                    |     |  |           |     |  |  |  |     |     |  |        |  |        |           |     |
+  +--+  +  +  +--+--+--+--+--+--+--+  +--+--+--+--+  +--+--+  +--+  +--+--+--+  +--+  +  +  +  +--+--+  +  +--+--+  +  +--+--+  +--+--+--+--+--+  +
|  |     |  |        |              |           |     |     |  |     |        |        |  |  |        |     |  |     |                          |  |
+  +  +--+  +--+--+  +  +--+--+--+  +--+--+--+  +  +--+  +  +  +  +--+--+  +--+--+--+  +  +  +--+  +--+--+  +  +  +--+  +--+--+--+--+--+--+--+  +  +
|     |  |  |        |  |     |                 |  |     |  |              |        |  |  |     |  |     |  |  |     |  |        |        |     |  |
+  +--+  +  +  +--+--+  +  +  +--+--+--+--+--+--+--+  +--+  +--+--+--+--+--+  +--+  +  +  +--+  +  +  +  +  +  +--+  +  +  +--+  +  +--+  +  +--+  +
|  |     |           |     |           |     |        |  |                       |     |  |     |     |  |  |     |  |  |     |     |     |        |
+  +  +--+--+--+--+--+--+--+--+--+--+  +  +  +  +--+--+  +--+--+--+--+--+--+  +--+--+--+  +  +--+--+--+  +  +  +  +  +--+--+  +--+--+  +--+--+--+--+
|     |                                |  |  |  |        |                 |  |           |  |           |  |  |  |  |        |     |              |
+--+--+  +  +--+--+--+--+  +--+--+--+--+  +  +  +  +--+--+  +--+  +--+--+  +--+  +--+--+  +  +  +--+--+  +  +--+  +  +  +--+--+  +  +--+--+--+--+  +
|     |  |  |        |     |              |  |     |     |     |  |     |        |        |  |        |  |  |     |     |  |     |              |  |
+  +  +  +--+  +--+  +--+  +  +--+--+--+--+  +--+  +  +  +  +  +--+  +  +--+--+--+--+  +--+  +--+--+  +  +  +  +--+--+--+  +  +--+--+--+--+--+  +  +
|  |     |     |  |     |  |        |     |  |     |  |  |  |  |     |              |     |        |  |  |  |              |                 |     |
+  +--+--+  +--+  +--+  +--+--+--+  +--+  +  +  +--+  +  +--+  +  +--+--+--+--+--+  +--+--+--+--+  +  +--+  +--+  +--+--+--+--+--+--+--+--+  +--+--+
|  |              |     |        |  |     |        |  |        |  |              |     |        |  |     |     |              |     |     |        |
+  +  +--+--+--+--+  +--+  +--+  +  +  +--+--+--+--+  +--+--+  +  +--+--+  +--+--+--+  +  +--+  +  +--+  +--+  +--+--+--+  +--+  +  +  +  +--+--+  +
|  |  |     |        |     |     |     |           |     |     |  |        |           |  |     |     |     |  |           |     |     |  |     |  |
+  +  +  +--+  +--+  +  +--+  +--+  +--+  +--+--+  +--+  +--+--+  +  +--+--+  +--+--+--+  +  +--+--+  +  +--+  +  +--+  +--+  +--+--+--+  +  +  +  +
|  |  |     |  |     |     |        |     |     |  |     |           |        |     |     |     |     |     |  |  |     |        |     |  |  |     |
+  +  +--+  +  +--+--+  +--+--+--+--+  +--+  +  +  +  +--+  +--+--+--+  +--+--+  +  +  +--+--+  +  +--+--+  +  +  +--+--+  +--+--+  +  +  +  +--+--+
|  |        |  |     |  |              |     |  |     |     |     |     |     |  |     |     |        |     |  |  |        |        |     |        |
+  +--+--+  +  +  +  +  +  +--+--+  +--+  +--+  +--+--+  +--+  +--+  +--+  +  +  +--+--+  +  +--+--+--+  +--+  +  +  +--+--+  +--+  +--+--+--+--+  +
|           |     |     |     |     |     |  |     |     |        |        |           |  |              |     |  |        |     |  |              |
+  +--+--+--+--+--+--+--+--+  +--+--+  +--+  +--+  +  +--+--+--+  +--+--+--+--+--+--+  +  +--+--+  +--+--+  +--+  +  +--+--+--+  +--+  +--+--+--+--+
|  |     |                 |        |     |  |     |     |        |                 |  |        |  |     |  |     |  |           |     |           |
+  +--+  +  +  +--+--+--+  +--+  +  +--+  +  +  +--+--+  +  +--+  +  +--+--+--+--+  +--+--+--+  +--+  +  +  +  +--+  +  +  +--+--+  +  +  +--+--+  +
|        |  |  |     |        |  |     |  |  |        |  |  |     |  |           |        |     |     |     |  |     |  |  |        |  |  |     |  |
+--+--+  +  +--+  +  +--+--+  +--+--+  +  +  +--+--+  +  +  +--+  +  +  +--+--+  +--+--+  +  +--+  +--+--+--+  +  +--+  +--+  +--+--+--+  +  +  +  +
|        |     |  |        |        |              |  |  |     |  |  |        |  |     |     |     |                 |  |     |              |  |  |
+--+--+--+--+  +  +--+--+  +--+--+  +--+--+--+--+--+  +  +--+  +--+  +--+--+  +  +  +  +--+--+  +--+  +--+--+--+--+--+  +  +--+  +--+--+--+--+--+  +
|           |     |        |     |                    |     |     |           |     |  |        |     |     |           |     |        |           |
+  +--+--+  +--+  +  +--+--+  +  +--+--+--+--+--+--+  +--+  +--+  +--+--+--+--+--+--+  +  +--+--+  +--+  +  +  +--+--+  +--+  +--+--+  +  +--+--+--+
|     |  |     |  |  |        |  |     |     |  |        |     |  |                 |     |     |  |  |  |  |     |        |     |     |     |     |
+--+  +  +--+  +  +  +  +--+--+  +  +  +  +  +  +  +--+--+--+  +  +  +--+--+--+  +  +--+--+  +--+  +  +  +  +  +  +  +--+--+  +  +  +--+--+  +  +  +
|     |     |  |  |  |     |  |  |  |     |  |     |           |  |     |     |  |     |     |     |  |  |  |  |  |     |     |  |  |  |     |  |  |
+  +--+  +--+  +--+  +--+  +  +  +  +--+--+  +--+--+  +--+--+--+  +--+  +  +  +--+--+  +  +  +  +--+  +  +  +  +  +--+--+  +--+--+  +  +  +--+  +  +
|     |                 |  |  |  |  |     |           |     |           |  |        |  |  |           |  |  |  |  |        |           |        |  |
+--+  +--+--+--+  +--+--+  +  +  +  +--+  +--+--+--+--+  +--+  +--+--+--+  +--+--+  +  +  +--+--+--+--+  +  +--+  +  +--+--+  +--+--+--+--+--+--+  +
|     |        |  |           |  |        |  |           |     |     |     |        |  |  |           |  |     |  |  |        |                 |  |
+  +--+  +--+  +--+  +--+--+--+  +--+--+  +  +  +--+--+  +  +--+  +  +  +--+--+  +--+  +  +  +--+--+  +  +--+  +  +  +  +--+--+  +--+--+--+--+  +  +
|  |     |     |     |     |           |  |  |  |     |  |     |  |     |     |     |     |     |        |        |        |     |           |     |
+  +  +--+  +  +  +--+  +  +  +--+--+--+  +  +  +--+  +  +--+  +  +--+  +  +  +--+  +--+--+--+  +--+--+--+--+--+--+--+--+  +  +--+  +--+--+  +--+  +
|     |  |  |  |  |     |  |              |  |        |        |  |     |  |  |                 |                    |     |     |        |     |  |
+  +--+  +  +--+  +  +--+  +--+--+--+--+--+  +--+  +--+--+--+  +  +  +--+  +  +  +--+--+--+--+--+  +--+--+--+--+--+  +--+--+--+  +--+  +--+--+  +--+
|     |  |  |     |  |     |                       |        |  |  |  |     |  |     |     |     |  |  |     |     |           |        |     |     |
+--+  +  +  +  +--+--+  +  +--+--+--+--+--+--+--+--+  +--+  +--+  +  +  +--+  +--+--+  +  +  +  +  +  +  +  +  +  +--+--+--+  +--+--+--+  +  +--+  +
|        |              |                             |           |  |     |           |     |     |     |     |                          |        |
+--+--+--+--+--+--+--+--+--+--+--+--+--+--+--+--+--+--+--+--+--+--+--+--+  +--+--+--+--+--+--+--+--+--+--+--+--+--+--+--+--+--+--+--+--+--+--+--+--+
